..........#.##....#.#........#...#.....#..##......##..#.#..##....#.#.##.#..#.#...#..#...#...##..
......#...#....#..#...###.................#.#......##.#..#......#....#.......#..#..##...#.#..#..
#....#..............#...#.##..#...#..##.#.#.#...#.#...###...#..........#...#...#...#...#.##.....
#....#..##................#....#.#...#.##.#.....###...###...#..#....#......#...#.#..####......##
.....#..#.#..#...#.......#........#.....#..#..#..#......#..#...#.#..####....###........#.....#..
..#.#..##.......#.##.........#...#......##...#...#.##....##.##.....##.....####.....##..........#
......###....#.......#....#.#.##..#.##.#.####........#...#####..#........#.......#...#..........
...#.....#.....#.#..............##.#...###......#..#..#.........#.#.#..#.....#....#......##.##..
####...#..#..#.....#..#........#..#..#..#.#...........###.....#...##..###.#.....#.##....###...#.
..#...##.....##.##.#......#..#.#..#..#.#.....#..#...#.....#.#...#.....##...#..#.##.#...##...##.#
..#.#.....#..#.#..#.#.#.......#..#.###....###......#....#....#.........##..##..#....#..##.#.#.##
.##.#......#.#####.......###.#..........#....#.........#...##....#.#...#.##.#....#.#...#....##.#
...#.##.................#...##.....#.#...#.........#..#..#.#..........#...#.#...#...###.#.....#.
#..#...##.#.....#.##.##..###.#.....####..#..#.#.....#........#...#...#.##..#.##........#...##...
....#.....##.....##...###...#.###.#.....#.#.#.......###.#...#..#.....##....#..#.....#.#....#...#
...#.##..#..##...#....##.#..##.#..........#....#..#....#..#.#.....##..#....##.......#....##.....
....#......##.#.##.#..###....###..###.#..##.....###...#..................#..#..#...##...........
..#..####..##.....##....###.#..####.##..#.##.#.......#.#....##....##...#.......#.#......##....##
.#...##....#....#....#.....#.##..#.....#....#..#...#.#...##...#...#..#...#..#.#...#.....#.##....
.......#...##..#.#.#.........##..##...........#..#..#.#..#.....#..#.#.#.#........#..##.#.#..#.#.
..#....##...#....#....#.#..#..#..#.#...#........##..####.#####...##.#...#.####.#....#.#...#.#...
..##.#...#.....##.#.##....######........#....###......#.#.#...#..........##..#..##.#.#...#...#..
#.......#..#..#..#......##..###.#..###.#.....#.#...##.##..#...##.......#.#...........#.....##...
#...#..#.#.........#...#..#.##.##..#........#.....#..###..#.#........#.#.#...#.#.#..##..........
##..#....#........##...#####....#.....#......###.#.....###..#..#.........#..#...#...###.........
..####....##....##....#.......#..###.........#.........#.....#....#.#.#.....#...#.....##........
#.#.#.##.#..##.#..#.##....##..#..........#.#...###.....#####..#....#.#........#.#..##....#..#...
#....#.#..#.....###......#..#.....#.##........#.##.#.....####..###.##.##.#####.##..#....#.#.....
..#.###.#...#..##.#...#.#.......##.#.##.#..#.#..#.##........#..##.#..#..#.##..##.........#.#...#
###...#....##.............#...#..........#...##..#....#....#.#....#...#.#..#......##.#......#...
.......#........#..#.......#......#....#...#..........##...#.#.#.###......#..#..............##..
.#..#.....##...............#.##.........#.##..#.###.#.#..#...........#...#.....#.##...#.........
........#.....#.#..#....#....#..#........#...#.....#..#.###...........#..#.#..####..##.#.##..#..
#.......######.#....#.#..#........#...#.............#.###..#.....##.#..............#...#.#..#...
..#...#..#..###.....##..###.#..##....####..#..#.....#............#...............##.##.#.##.#...
....##..#.......#...###...##..#.##..#..#..#...#.#.....##...##.........#..##.....#.#...###..#....
.#............#............#.......#..##..##....#..........#...#....#....#..#..........###..#...
...#..#.#..#.#.#.#.....###.#..#...#..#.....#....#.#....#..........####.#..###..###.#..#.##.....#
..#....#.#.#.##.#......#......#.###...#...##.....#...#.#.#..#......#..#..#.##.##..#.###.#.#.....
.....##.##....#.......##................##....#....#..............#..#.#..###...#.#........###..
..#.#.#..#..........##.#...#.#...#.#..#..#..##.####..#..#..#........##..#........#.#.#.#..##..#.
...#.......#..#..#.#....#.......##.....###.#..#................#.#.....##.#..#...#.#...###.###..
......#...........###.##.########....#..##..##.#...#..#..#....#....#........#....##.........#.##
#.##..#..#..##.......#.###.#..##.#..#.#....#.......#........#.#....#...#.#...#..#.....#........#
.##..##..##..##....#....#......#..#......####....##....##.#.##.#......##..#....#.#..#...........
#....##....##.##....#..##.#....#.#...#..#....#..##.#..##.#####...#....#.....#..#..#.....#......#
.#.#....##.....#..#...#.....#..#.#....###.#.....#..##.#....#....#.........#.......#.###.#...####
..#...#.#......##.#.####........#..#....#..##..#...###..#...#....#...#.....###.........#.......#
.......#...#..#..#....#......#...#.....#.#..#..##.#..#..##....##..#.##...##....#..#....#..##..##
##..##.##...#####......#####..........#####.#......####......###................##.#.....#..#..#
##..###.#..##....##....#.....#...#.#####....##...####..##..#..##..#......#.#...#...#.......#....
.#..####..#..#.###.#..##...#........#.#.#..#..##.#..#..#.##.##...#...#...#.#.#.#.##.#.#..#.#.##.
.............##....#.......#.......##.#.#.##...#.........#..#.......#..#.#..#.....#.#.##.....##.
##..#..#..##.#....#........#...#.#......##....#...#.#...#....#.....#..#.#.#.#....#.#.#..#.......
.....#............#.#...#...##...#.............##...#..#.###.#...#....#....#.............##.#.##
...#..#......##.####...####...##.#..##.....#..#...#.####.##.....#.#.#...#.#.......##..#.#...####
#..#..#........#....#..##.####..#..###....#.##.#..........#...#.##.#.##..#....#.......##....#...
........##........................#....#.#..#..#...#....#...#.#......#..##.##.#..#..........#...
..#..##.#....#...#.....#..#.......#####..#.##......#####..#.#.....#.#......#..##....#####...#...
##....#..##...##.#...#..#.#.#...##..#..#...#.#...##...####....#....#..##......#.................
#....##.....#.#..##..#....###..#.####..#..##..#.#....####...##....##....##...#..#....#.......#..
.#......#....##....#......#.##..#..#......#.......#.....#..#.#####..#..#.##..#....#.##..#.#...#.
..#.#.#..#.###...#........####.#.#........#...###.####..##.##....##..#.....###......##..##...#..
........##............#.#....#.#..##...##.#...######....#......##....#..#.......#...#....##.#.#.
...#...#...#..##.....#.###....###...####.###....#..#...#..........#..........#.....##......#....
..##..#.#..#........###...#..#..##.##.#..###......##.##.##..####...#.......##...#.......#..#..##
.#.#.....#.............#.#..#..#.#...##.##.#......#......#....##....#.#....#.......#....#..#...#
..#..........#...#.#.#.........#.....#............##.#...#.....#..#..#..###....#......#..##...#.
#............#....##.........#...###..........###...#.#..#...#..###....###............#..#.#..#.
##..#......#....#.......##...........#............###......##.#....#..##.#.##..#..##.#.#....#.#.
.#..#..#............#..#.###..#..##....#..#.#........####...##.##...###..#.......#.#.#......#.##
#.#....#....##....#....#.#.#..#..#.....#......#..#..#...##.##...##.#......#..#.##...#...........
..#.#...#..#.#.#........#......#####..#.#....###..#.....#....#....#.....##.#.....#.#...##....#..
...#.......##.##...##........#..###.................#.###.#.#....##...#....##..#...#..#.##.#.#..
..#.##...........#.#...#...#.##.#.#..#....#....#.........#........#....##.#..#....#..#.....#..#.
##...#.#..##....#.......#.##..#.#.#....#.#.###.#........##.#.....#..##.#....#....#.#.....#......
.##........#...........#.........#....#.........##........#.#.......###.#..........#.........#..
.##..#...#..#..........##...#.....##...#..#.....####...##....###...##...#.....#............#...#
.##.......##.#..#..#.##..#.#......#....#.....#...#.#.##.##.###.#..#..##.#..#......#.##......##..
##..#.......#..#.#....##....#...#......#.##...###.#..#...#...#..#..#...#...###.###.............#
#.#...#.....#.....#...#..#...#....#..#........###...........#....###................#...#...##..
....#........#......###.###.#..##....####..#..###..#...#...#..##..#.##.#...#..#...###...#..#....
..##..#....#..#.##...#....###.#..#..#..#..##.....#.#..#............######..#.##....##...##.##...
...#...###.#.###.####.........##.........##.#......#..#.....#.#.#..#.###.##.#####.#..#..#.##....
......#..#....##........##.##...##.....#...#.#.............##..................#....#....##...#.
..#...###..#...#..##.......#....##..###..##.#....#...#..##..##...###....#.......#.#.#...#..#..#.
...##.#......#....#........##....###.##.......#...#...##.......#..................#.#....###.#..
......#.#.....#...##.........#......##.....##....#..#..#.....####..#.....#.......#..###......###
.#............##..#......#............##..#..#.....#...........###.##.......#............##...#.
#.#.....#....#.#.....#.#.#..#...#....###...###....###...#.....#.##......#...#......#......##..##
..##.......##...#...#..#..#.............#.###.#..#..#..#.#.#...#.#..##.....#.........##.......#.
.#..#.##..#.##..........#...#....#.....#......##..#.....#.#..#..#..##....#.#....##.#......#...##
...#..#......#...#.....##.#.#..#...................#..#.....##..##.#.....#...#.#..#....#.......#
.#...##......#..#..#.#...##.#....#.#.#.###..#.##.#.#.......##....##.#.#............#...#...#...#
.##.......#.##..#.......#..#.......#...........#.##....#........##....#.......##.....#..#.....#.
#........##.#.#.#.....##.#....#.##.#..#.....#..............#.###.##......#....#....#.##.....#...